date,away_score,home_score,actual_score,over_under,score_diff
2015-09-03,15,14,29,47.0,18
2015-09-03,17,13,30,62.0,32
2015-09-03,24,13,37,58.0,21
2015-09-03,36,48,84,64.5,-19.5
2015-09-03,3,41,44,40.5,-3.5
2015-09-03,6,69,75,65.0,-10
2015-09-03,15,20,35,51.0,16
2015-09-03,14,12,26,60.0,34
2015-09-03,17,24,41,44.5,3.5
2015-09-03,9,12,21,47.0,26
2015-09-03,45,28,73,57.5,-15.5
2015-09-03,23,17,40,60.0,20
2015-09-03,37,7,44,52.5,8.5
2015-09-03,13,34,47,58.0,11
2015-09-03,32,42,74,58.5,-15.5
2015-09-03,17,31,48,59.5,11.5
2015-09-03,13,43,56,53.0,-3
2015-09-03,20,28,48,62.5,14.5
2015-09-04,23,20,43,68.0,25
2015-09-04,37,24,61,55.5,-5.5
2015-09-04,56,21,77,71.0,-6
2015-09-04,0,47,47,43.5,-3.5
2015-09-04,37,35,72,63.0,-9
2015-09-04,7,26,33,53.0,20
2015-09-04,13,16,29,55.5,26.5
2015-09-05,14,51,65,54.0,-11
2015-09-05,6,16,22,47.5,25.5
2015-09-05,3,52,55,53.0,-2
2015-09-05,13,48,61,49.5,-11.5
2015-09-05,24,31,55,58.0,3
2015-09-05,16,34,50,52.5,2.5
2015-09-05,33,28,61,59.5,-1.5
2015-09-05,38,34,72,61.0,-11
2015-09-05,10,27,37,44.0,7
2015-09-05,44,47,91,67.0,-24
2015-09-05,30,59,89,69.5,-19.5
2015-09-05,21,49,70,63.0,-7
2015-09-05,3,41,44,57.5,13.5
2015-09-05,17,38,55,70.0,15
2015-09-05,33,40,73,58.0,-15
2015-09-05,3,38,41,48.5,7.5
2015-09-05,0,44,44,56.0,12
2015-09-05,13,61,74,54.5,-19.5
2015-09-05,30,38,68,62.0,-6
2015-09-05,17,35,52,48.5,-3.5
2015-09-05,16,59,75,63.0,-12
2015-09-05,34,16,50,61.5,11.5
2015-09-05,6,55,61,69.5,8.5
2015-09-06,31,41,72,61.5,-10.5
2015-09-07,42,24,66,52.5,-13.5
2015-09-10,38,41,79,62.5,-16.5
2015-09-11,44,20,64,56.0,-8
2015-09-11,14,24,38,44.5,6.5
2015-09-12,14,34,48,54.5,6.5
2015-09-12,7,35,42,45.0,3
2015-09-12,17,22,39,47.0,8
2015-09-12,30,3,33,52.0,19
2015-09-12,48,27,75,72.0,-3
2015-09-12,34,31,65,54.0,-11
2015-09-12,14,27,41,48.5,7.5
2015-09-12,0,58,58,52.0,-6
2015-09-12,17,30,47,40.5,-6.5
2015-09-12,10,41,51,58.5,7.5
2015-09-12,14,48,62,62.5,0.5
2015-09-12,20,69,89,65.5,-23.5
2015-09-12,0,38,38,65.0,27
2015-09-12,23,20,43,54.5,11.5
2015-09-12,37,34,71,62.5,-8.5
2015-09-12,10,65,75,54.5,-20.5
2015-09-12,34,27,61,47.5,-13.5
2015-09-12,31,14,45,50.0,5
2015-09-12,21,73,94,55.0,-39
2015-09-12,10,37,47,56.5,9.5
2015-09-12,16,12,28,55.5,27.5
2015-09-12,48,29,77,53.0,-24
2015-09-12,31,17,48,50.0,2
2015-09-12,7,35,42,60.5,18.5
2015-09-12,31,24,55,63.0,8
2015-09-12,24,7,31,50.0,19
2015-09-12,17,43,60,56.0,-4
2015-09-12,10,21,31,60.0,29
2015-09-12,13,31,44,60.0,16
2015-09-12,44,20,64,63.0,-1
2015-09-12,23,56,79,63.5,-15.5
2015-09-12,27,20,47,55.5,8.5
2015-09-12,24,31,55,53.0,-2
2015-09-12,55,23,78,63.0,-15
2015-09-12,26,22,48,56.0,8
2015-09-12,9,59,68,66.5,-1.5
2015-09-12,28,31,59,67.0,8
2015-09-12,9,48,57,54.0,-3
2015-09-12,28,42,70,48.5,-21.5
2015-09-12,22,36,58,56.5,-1.5
2015-09-12,34,32,66,64.5,-1.5
2015-09-12,34,26,60,56.0,-4
2015-09-12,40,21,61,72.0,11
2015-09-12,21,19,40,52.0,12
2015-09-12,16,37,53,58.0,5
2015-09-12,24,35,59,57.0,-2
2015-09-12,37,3,40,64.0,24
2015-09-12,7,31,38,46.5,8.5
2015-09-17,20,17,37,53.5,16.5
2015-09-18,14,0,14,47.5,33.5
2015-09-18,0,52,52,60.5,8.5
2015-09-18,10,34,44,64.0,20
2015-09-19,17,35,52,51.0,-1
2015-09-19,7,28,35,48.0,13
2015-09-19,21,35,56,54.0,-2
2015-09-19,7,10,17,46.5,29.5
2015-09-19,33,15,48,63.5,15.5
2015-09-19,27,44,71,65.0,-6
2015-09-19,14,48,62,64.0,2
2015-09-19,6,9,15,41.0,26
2015-09-19,17,14,31,50.0,19
2015-09-19,38,52,90,71.5,-18.5
2015-09-19,27,30,57,44.5,-12.5
2015-09-19,19,10,29,48.5,19.5
2015-09-19,28,61,89,72.5,-16.5
2015-09-19,38,24,62,55.0,-7
2015-09-19,25,23,48,55.0,7
2015-09-19,28,17,45,63.0,18
2015-09-19,44,41,85,78.5,-6.5
2015-09-19,33,39,72,50.0,-22
2015-09-19,3,28,31,58.5,27.5
2015-09-19,13,20,33,66.5,33.5
2015-09-19,37,33,70,60.0,-10
2015-09-19,21,45,66,57.0,-9
2015-09-19,14,69,83,56.0,-27
2015-09-19,51,24,75,48.5,-26.5
2015-09-19,22,30,52,55.0,3
2015-09-19,33,36,69,59.5,-9.5
2015-09-19,21,45,66,48.5,-17.5
2015-09-19,35,38,73,73.0,0
2015-09-19,17,31,48,44.0,-4
2015-09-19,20,52,72,53.0,-19
2015-09-19,14,73,87,64.5,-22.5
2015-09-19,56,50,106,67.5,-38.5
2015-09-19,35,24,59,71.0,12
2015-09-19,38,14,52,58.0,6
2015-09-19,27,24,51,56.5,5.5
2015-09-19,14,9,23,51.5,28.5
2015-09-19,45,44,89,57.0,-32
2015-09-19,3,28,31,45.5,14.5
2015-09-19,50,47,97,61.0,-36
2015-09-19,34,27,61,45.5,-15.5
2015-09-19,24,27,51,47.0,-4
2015-09-19,41,31,72,50.0,-22
2015-09-19,21,35,56,49.5,-6.5
2015-09-19,37,56,93,67.0,-26
2015-09-19,23,30,53,58.0,5
2015-09-19,14,31,45,65.5,20.5
2015-09-19,43,37,80,52.5,-27.5
2015-09-19,23,24,47,59.5,12.5
2015-09-19,45,24,69,53.0,-16
2015-09-24,46,53,99,66.5,-32.5
2015-09-25,56,14,70,48.5,-21.5
2015-09-25,42,24,66,45.0,-21
2015-09-26,14,27,41,63.0,22
2015-09-26,0,31,31,46.0,15
2015-09-26,10,30,40,54.5,14.5
2015-09-26,28,36,64,67.0,3
2015-09-26,20,34,54,56.0,2
2015-09-26,14,31,45,45.0,0
2015-09-26,34,24,58,46.5,-11.5
2015-09-26,28,18,46,48.0,2
2015-09-26,35,28,63,74.5,11.5
2015-09-26,31,24,55,54.0,-1
2015-09-26,14,17,31,47.0,16
2015-09-26,17,27,44,55.0,11
2015-09-26,38,28,66,56.0,-10
2015-09-26,6,45,51,57.0,6
2015-09-26,17,70,87,74.0,-13
2015-09-26,16,62,78,54.5,-23.5
2015-09-26,24,27,51,47.0,-4
2015-09-26,30,27,57,60.5,3.5
2015-09-26,28,35,63,49.5,-13.5
2015-09-26,27,28,55,47.5,-7.5
2015-09-26,49,0,49,54.0,5
2015-09-26,27,62,89,59.5,-29.5
2015-09-26,12,38,50,63.0,13
2015-09-26,21,37,58,40.0,-18
2015-09-26,36,29,65,46.5,-18.5
2015-09-26,14,56,70,67.0,-3
2015-09-26,24,21,45,55.0,10
2015-09-26,0,34,34,54.0,20
2015-09-26,25,27,52,62.0,10
2015-09-26,55,52,107,82.5,-24.5
2015-09-26,30,24,54,60.0,6
2015-09-26,58,36,94,55.5,-38.5
2015-09-26,28,21,49,58.0,9
2015-09-26,16,27,43,53.0,10
2015-09-26,33,31,64,56.0,-8
2015-09-26,17,7,24,65.0,41
2015-09-26,35,14,49,50.0,1
2015-09-26,7,37,44,58.0,14
2015-09-26,17,9,26,59.0,33
2015-09-26,13,21,34,44.5,10.5
2015-09-26,63,13,76,55.0,-21
2015-09-26,56,30,86,65.0,-21
2015-09-26,19,24,43,48.5,5.5
2015-09-26,0,28,28,50.0,22
2015-09-26,14,59,73,72.5,-0.5
2015-09-26,62,20,82,64.0,-18
2015-09-26,44,20,64,67.0,3
2015-09-26,23,49,72,54.5,-17.5
2015-09-26,42,14,56,60.0,4
2015-10-01,23,34,57,71.0,14
2015-10-02,24,17,41,62.5,21.5
2015-10-02,37,3,40,43.5,3.5
2015-10-02,13,30,43,45.0,2
2015-10-03,31,45,76,44.0,-32
2015-10-03,38,24,62,81.0,19
2015-10-03,10,24,34,41.5,7.5
2015-10-03,17,13,30,44.5,14.5
2015-10-03,14,20,34,44.5,10.5
2015-10-03,13,38,51,59.0,8
2015-10-03,24,44,68,59.5,-8.5
2015-10-03,7,50,57,73.0,16
2015-10-03,28,0,28,45.0,17
2015-10-03,21,24,45,54.0,9
2015-10-03,0,27,27,39.0,12
2015-10-03,10,6,16,45.0,29
2015-10-03,20,13,33,46.5,13.5
2015-10-03,14,12,26,44.5,18.5
2015-10-03,24,10,34,54.0,20
2015-10-03,19,29,48,51.5,3.5
2015-10-03,14,24,38,56.5,18.5
2015-10-03,34,27,61,66.5,5.5
2015-10-03,11,33,44,49.0,5
2015-10-03,13,31,44,52.5,8.5
2015-10-03,28,22,50,67.0,17
2015-10-03,14,20,34,43.0,9
2015-10-03,35,63,98,89.0,-9
2015-10-03,7,27,34,54.0,20
2015-10-03,49,10,59,71.5,12.5
2015-10-03,7,9,16,37.0,21
2015-10-03,24,16,40,44.0,4
2015-10-03,38,31,69,62.0,-7
2015-10-03,38,10,48,51.0,3
2015-10-03,21,35,56,56.0,0
2015-10-03,28,34,62,74.0,12
2015-10-03,34,36,70,49.0,-21
2015-10-03,49,23,72,67.0,-5
2015-10-03,13,14,27,57.0,30
2015-10-03,14,49,63,66.5,3.5
2015-10-03,10,38,48,49.5,1.5
2015-10-03,24,20,44,52.5,8.5
2015-10-03,22,44,66,59.0,-7
2015-10-03,17,13,30,48.0,18
2015-10-03,14,43,57,60.0,3
2015-10-03,23,17,40,57.5,17.5
2015-10-03,18,33,51,49.5,-1.5
2015-10-03,24,18,42,62.0,20
2015-10-03,35,49,84,59.5,-24.5
2015-10-03,51,31,82,47.5,-34.5
2015-10-03,17,30,47,63.0,16
2015-10-03,38,23,61,61.5,0.5
2015-10-03,22,24,46,48.5,2.5
2015-10-03,25,6,31,57.0,26
2015-10-03,29,38,67,66.5,-0.5
2015-10-03,41,24,65,70.0,5
2015-10-03,0,55,55,55.5,0.5
2015-10-03,7,21,28,54.0,26
2015-10-03,17,55,72,60.5,-11.5
2015-10-08,28,49,77,70.5,-6.5
2015-10-08,17,12,29,57.5,28.5
2015-10-09,10,31,41,57.0,16
2015-10-09,13,28,41,44.0,3
2015-10-10,44,3,47,47.0,0
2015-10-10,3,52,55,69.5,14.5
2015-10-10,12,52,64,44.0,-20
2015-10-10,28,58,86,70.5,-15.5
2015-10-10,20,29,49,46.0,-3
2015-10-10,66,7,73,75.5,2.5
2015-10-10,17,24,41,59.5,18.5
2015-10-10,28,49,77,55.5,-21.5
2015-10-10,7,29,36,53.5,17.5
2015-10-10,10,49,59,44.0,-15
2015-10-10,39,41,80,50.5,-29.5
2015-10-10,19,26,45,46.5,1.5
2015-10-10,3,34,37,50.0,13
2015-10-10,38,62,100,78.5,-21.5
2015-10-10,27,26,53,58.5,5.5
2015-10-10,3,0,3,36.5,33.5
2015-10-10,47,21,68,52.5,-15.5
2015-10-10,7,38,45,46.0,1
2015-10-10,37,3,40,62.5,22.5
2015-10-10,41,59,100,57.0,-43
2015-10-10,24,43,67,54.0,-13
2015-10-10,24,45,69,50.0,-19
2015-10-10,31,38,69,59.5,-9.5
2015-10-10,24,45,69,46.5,-22.5
2015-10-10,24,41,65,56.0,-9
2015-10-10,0,38,38,34.5,-3.5
2015-10-10,23,21,44,48.5,4.5
2015-10-10,41,13,54,47.5,-6.5
2015-10-10,31,66,97,74.0,-23
2015-10-10,40,13,53,38.0,-15
2015-10-10,7,44,51,65.0,14
2015-10-10,17,45,62,56.0,-6
2015-10-10,45,38,83,73.0,-10
2015-10-10,24,34,58,67.0,9
2015-10-10,41,10,51,59.5,8.5
2015-10-10,27,49,76,70.0,-6
2015-10-10,17,35,52,53.5,1.5
2015-10-10,14,27,41,47.5,6.5
2015-10-10,34,31,65,53.0,-12
2015-10-10,33,26,59,60.0,1
2015-10-10,52,45,97,63.0,-34
2015-10-10,21,3,24,37.5,13.5
2015-10-10,38,45,83,58.0,-25
2015-10-10,24,29,53,50.5,-2.5
2015-10-10,31,24,55,52.5,-2.5
2015-10-10,33,27,60,50.0,-10
2015-10-10,23,48,71,58.0,-13
2015-10-10,24,30,54,61.0,7
2015-10-10,17,31,48,56.0,8
2015-10-10,56,14,70,47.0,-23
2015-10-10,28,14,42,45.5,3.5
2015-10-13,49,31,80,58.5,-21.5
2015-10-15,30,27,57,56.5,-0.5
2015-10-15,55,28,83,71.5,-11.5
2015-10-15,35,56,91,55.5,-35.5
2015-10-16,24,38,62,68.5,6.5
2015-10-16,42,7,49,57.5,8.5
2015-10-16,26,52,78,49.0,-29
2015-10-16,28,31,59,51.5,-7.5
2015-10-17,49,14,63,52.0,-11
2015-10-17,20,63,83,58.5,-24.5
2015-10-17,28,20,48,45.0,-3
2015-10-17,17,30,47,79.0,32
2015-10-17,7,24,31,50.0,19
2015-10-17,33,17,50,46.5,-3.5
2015-10-17,34,42,76,56.5,-19.5
2015-10-17,30,20,50,77.5,27.5
2015-10-17,14,21,35,45.0,10
2015-10-17,38,62,100,78.0,-22
2015-10-17,40,10,50,42.0,-8
2015-10-17,24,37,61,71.0,10
2015-10-17,20,45,65,60.5,-4.5
2015-10-17,21,41,62,46.0,-16
2015-10-17,31,28,59,46.0,-13
2015-10-17,14,51,65,56.0,-9
2015-10-17,45,12,57,56.5,-0.5
2015-10-17,10,59,69,66.5,-2.5
2015-10-17,31,19,50,68.0,18
2015-10-17,15,10,25,55.5,30.5
2015-10-17,23,38,61,54.5,-6.5
2015-10-17,19,16,35,61.5,26.5
2015-10-17,20,30,50,52.0,2
2015-10-17,41,23,64,53.5,-10.5
2015-10-17,38,44,82,54.5,-27.5
2015-10-17,55,0,55,54.5,-0.5
2015-10-17,55,52,107,65.0,-42
2015-10-17,27,23,50,41.5,-8.5
2015-10-17,48,25,73,49.0,-24
2015-10-17,34,37,71,49.5,-21.5
2015-10-17,10,19,29,43.5,14.5
2015-10-17,31,52,83,60.0,-23
2015-10-17,21,28,49,52.5,3.5
2015-10-17,26,56,82,62.5,-19.5
2015-10-17,59,14,73,50.0,-23
2015-10-17,27,28,55,50.0,-5
2015-10-17,28,35,63,46.5,-16.5
2015-10-17,14,50,64,52.0,-12
2015-10-17,17,34,51,37.5,-13.5
2015-10-17,10,32,42,57.5,15.5
2015-10-17,45,21,66,71.0,5
2015-10-17,16,30,46,47.0,1
2015-10-17,31,41,72,61.0,-11
2015-10-17,6,9,15,45.0,30
2015-10-17,10,38,48,47.0,-1
2015-10-17,38,31,69,69.0,0
2015-10-17,18,34,52,57.0,5
2015-10-17,26,20,46,59.0,13
2015-10-17,30,7,37,49.0,12
2015-10-20,27,37,64,57.0,-7
2015-10-22,24,14,38,52.0,14
2015-10-22,13,31,44,61.5,17.5
2015-10-22,24,40,64,68.0,4
2015-10-23,66,42,108,76.0,-32
2015-10-23,14,48,62,43.0,-19
2015-10-24,59,10,69,53.5,-15.5
2015-10-24,44,10,54,63.5,9.5
2015-10-24,9,23,32,47.5,15.5
2015-10-24,35,17,52,45.5,-6.5
2015-10-24,23,20,43,48.5,5.5
2015-10-24,30,28,58,49.5,-8.5
2015-10-24,31,38,69,54.0,-15
2015-10-24,27,45,72,74.0,2
2015-10-24,46,54,100,51.0,-49
2015-10-24,58,0,58,54.5,-3.5
2015-10-24,14,17,31,37.0,6
2015-10-24,14,31,45,54.5,9.5
2015-10-24,48,0,48,59.0,11
2015-10-24,14,42,56,55.0,-1
2015-10-24,13,35,48,55.5,7.5
2015-10-24,51,35,86,62.0,-24
2015-10-24,23,21,44,55.5,11.5
2015-10-24,21,49,70,67.5,-2.5
2015-10-24,13,26,39,59.0,20
2015-10-24,17,41,58,54.0,-4
2015-10-24,16,45,61,64.5,3.5
2015-10-24,13,30,43,60.0,17
2015-10-24,24,13,37,45.5,8.5
2015-10-24,31,30,61,46.5,-14.5
2015-10-24,26,52,78,61.5,-16.5
2015-10-24,45,43,88,44.0,-44
2015-10-24,14,19,33,51.5,18.5
2015-10-24,27,63,90,73.5,-16.5
2015-10-24,10,58,68,58.0,-10
2015-10-24,45,42,87,74.5,-12.5
2015-10-24,3,10,13,34.0,21
2015-10-24,14,38,52,58.5,6.5
2015-10-24,20,30,50,51.0,1
2015-10-24,13,37,50,57.5,7.5
2015-10-24,13,27,40,58.0,18
2015-10-24,12,41,53,53.0,0
2015-10-24,17,27,44,55.5,11.5
2015-10-24,16,22,38,54.5,16.5
2015-10-24,3,23,26,62.0,36
2015-10-24,20,48,68,66.5,-1.5
2015-10-24,18,36,54,63.5,9.5
2015-10-24,21,31,52,57.0,5
2015-10-24,16,42,58,56.0,-2
2015-10-24,24,42,66,60.5,-5.5
2015-10-24,49,7,56,64.0,8
2015-10-24,52,7,59,58.5,-0.5
2015-10-24,14,34,48,56.5,8.5
2015-10-24,17,13,30,59.5,29.5
2015-10-24,14,31,45,47.5,2.5
2015-10-29,26,19,45,59.0,14
2015-10-29,10,40,50,75.5,25.5
2015-10-29,58,28,86,65.0,-21
2015-10-29,29,24,53,50.0,-3
2015-10-29,13,37,50,65.5,15.5
2015-10-29,61,55,116,65.0,-51
2015-10-30,20,19,39,42.0,3
2015-10-30,13,31,44,50.5,6.5
2015-10-30,42,17,59,61.5,2.5
2015-10-30,27,58,85,48.0,-37
2015-10-31,55,30,85,66.0,-19
2015-10-31,7,52,59,62.0,3
2015-10-31,17,29,46,50.5,4.5
2015-10-31,0,39,39,43.0,4
2015-10-31,45,55,100,54.0,-46
2015-10-31,10,48,58,52.0,-6
2015-10-31,27,19,46,57.5,11.5
2015-10-31,28,35,63,56.0,-7
2015-10-31,21,45,66,53.0,-13
2015-10-31,26,10,36,39.0,3
2015-10-31,10,20,30,66.0,36
2015-10-31,14,6,20,47.5,27.5
2015-10-31,13,34,47,58.0,11
2015-10-31,21,27,48,54.0,6
2015-10-31,27,21,48,69.5,21.5
2015-10-31,31,35,66,63.0,-3
2015-10-31,56,41,97,51.0,-46
2015-10-31,3,27,30,48.0,18
2015-10-31,34,10,44,52.0,8
2015-10-31,17,31,48,51.0,3
2015-10-31,62,7,69,61.0,-8
2015-10-31,70,53,123,79.0,-44
2015-10-31,15,31,46,53.0,7
2015-10-31,55,27,82,56.0,-26
2015-10-31,41,17,58,50.0,-8
2015-10-31,41,44,85,55.5,-29.5
2015-10-31,40,31,71,76.0,5
2015-10-31,28,63,91,61.5,-29.5
2015-10-31,24,30,54,55.5,1.5
2015-10-31,34,48,82,61.0,-21
2015-10-31,13,41,54,63.5,9.5
2015-10-31,12,27,39,53.0,14
2015-10-31,0,34,34,50.0,16
2015-10-31,30,27,57,50.0,-7
2015-10-31,29,26,55,37.5,-17.5
2015-10-31,0,24,24,52.0,28
2015-10-31,23,30,53,56.0,3
2015-10-31,52,21,73,57.5,-15.5
2015-10-31,24,20,44,51.0,7
2015-10-31,48,55,103,63.0,-40
2015-10-31,58,7,65,50.5,-14.5
2015-10-31,30,28,58,62.0,4
2015-10-31,3,49,52,58.0,6
2015-11-03,32,27,59,61.5,2.5
2015-11-04,24,62,86,68.5,-17.5
2015-11-05,18,17,35,43.5,8.5
2015-11-05,7,54,61,62.0,1
2015-11-05,40,27,67,55.5,-11.5
2015-11-05,31,24,55,69.0,14
2015-11-05,31,13,44,42.0,-2
2015-11-05,30,16,46,54.0,8
2015-11-06,60,40,100,51.0,-49
2015-11-06,21,24,45,57.0,12
2015-11-06,17,16,33,56.0,23
2015-11-07,17,13,30,53.5,23.5
2015-11-07,19,35,54,68.0,14
2015-11-07,30,45,75,63.0,-12
2015-11-07,21,23,44,41.0,-3
2015-11-07,48,14,62,52.0,-10
2015-11-07,31,48,79,52.5,-26.5
2015-11-07,26,31,57,81.0,24
2015-11-07,31,66,97,59.0,-38
2015-11-07,7,9,16,36.5,20.5
2015-11-07,3,27,30,58.0,28
2015-11-07,42,30,72,53.0,-19
2015-11-07,17,41,58,51.5,-6.5
2015-11-07,24,8,32,38.0,6
2015-11-07,42,10,52,56.0,4
2015-11-07,23,21,44,62.0,18
2015-11-07,13,28,41,63.0,22
2015-11-07,45,52,97,64.5,-32.5
2015-11-07,26,7,33,56.0,23
2015-11-07,21,27,48,52.5,4.5
2015-11-07,13,23,36,55.0,19
2015-11-07,53,52,105,54.0,-51
2015-11-07,3,20,23,50.5,27.5
2015-11-07,24,38,62,66.0,4
2015-11-07,35,27,62,59.5,-2.5
2015-11-07,31,24,55,48.5,-6.5
2015-11-07,16,49,65,50.0,-15
2015-11-07,29,49,78,76.5,-1.5
2015-11-07,13,56,69,62.0,-7
2015-11-07,24,27,51,57.0,6
2015-11-07,30,33,63,70.0,7
2015-11-07,14,51,65,53.0,-12
2015-11-07,13,14,27,58.0,31
2015-11-07,31,21,52,71.0,19
2015-11-07,7,3,10,47.5,37.5
2015-11-07,24,27,51,59.0,8
2015-11-07,41,0,41,58.0,17
2015-11-07,21,41,62,54.0,-8
2015-11-07,45,20,65,65.0,0
2015-11-07,36,31,67,54.0,-13
2015-11-07,16,52,68,60.0,-8
2015-11-07,38,39,77,56.0,-21
2015-11-07,34,23,57,44.0,-13
2015-11-07,26,10,36,60.0,24
2015-11-07,22,17,39,54.0,15
2015-11-07,16,30,46,45.5,-0.5
2015-11-07,20,59,79,53.0,-26
2015-11-07,14,28,42,53.5,11.5
2015-11-07,28,44,72,74.5,2.5
2015-11-07,30,38,68,67.0,-1
2015-11-10,0,27,27,44.0,17
2015-11-10,28,23,51,55.0,4
2015-11-11,41,30,71,54.5,-16.5
2015-11-11,41,27,68,72.0,4
2015-11-12,25,32,57,57.0,0
2015-11-12,23,21,44,51.0,7
2015-11-13,27,24,51,59.5,8.5
2015-11-14,31,13,44,49.0,5
2015-11-14,20,13,33,54.0,21
2015-11-14,24,14,38,46.0,8
2015-11-14,0,24,24,66.0,42
2015-11-14,34,31,65,43.0,-22
2015-11-14,20,38,58,53.0,-5
2015-11-14,28,3,31,55.0,24
2015-11-14,17,23,40,71.0,31
2015-11-14,7,24,31,54.0,23
2015-11-14,14,21,35,48.0,13
2015-11-14,24,17,41,58.0,17
2015-11-14,37,28,65,42.5,-22.5
2015-11-14,21,31,52,56.0,4
2015-11-14,17,34,51,54.5,3.5
2015-11-14,31,38,69,48.0,-21
2015-11-14,30,27,57,54.5,-2.5
2015-11-14,28,35,63,51.0,-12
2015-11-14,28,17,45,69.5,24.5
2015-11-14,59,21,80,56.5,-23.5
2015-11-14,17,27,44,51.0,7
2015-11-14,21,59,80,69.0,-11
2015-11-14,7,28,35,52.0,17
2015-11-14,37,27,64,58.0,-6
2015-11-14,31,6,37,51.0,14
2015-11-14,35,31,66,56.5,-9.5
2015-11-14,0,52,52,54.0,2
2015-11-14,31,14,45,65.0,20
2015-11-14,44,59,103,70.5,-32.5
2015-11-14,48,41,89,56.5,-32.5
2015-11-14,45,10,55,58.0,3
2015-11-14,65,10,75,60.5,-14.5
2015-11-14,14,55,69,61.0,-8
2015-11-14,34,37,71,52.0,-19
2015-11-14,41,19,60,66.0,6
2015-11-14,17,21,38,40.0,2
2015-11-14,47,20,67,66.5,-0.5
2015-11-14,23,44,67,44.5,-22.5
2015-11-14,35,49,84,59.0,-25
2015-11-14,34,35,69,70.0,1
2015-11-14,17,41,58,62.0,4
2015-11-14,31,14,45,54.5,9.5
2015-11-14,38,36,74,67.5,-6.5
2015-11-14,16,20,36,41.0,5
2015-11-14,38,49,87,76.0,-11
2015-11-14,44,34,78,77.0,-1
2015-11-14,35,40,75,45.5,-29.5
2015-11-14,30,37,67,61.5,-5.5
2015-11-14,31,24,55,58.0,3
2015-11-14,3,38,41,49.0,8
2015-11-14,24,54,78,63.0,-15
2015-11-14,31,27,58,67.0,9
2015-11-14,42,14,56,54.5,-1.5
2015-11-17,44,28,72,73.0,1
2015-11-17,31,48,79,56.0,-23
2015-11-18,27,14,41,40.5,-0.5
2015-11-18,19,27,46,59.5,13.5
2015-11-19,44,7,51,51.5,0.5
2015-11-19,3,16,19,58.0,39
2015-11-20,27,65,92,62.5,-29.5
2015-11-20,37,30,67,54.5,-12.5
2015-11-21,7,41,48,63.5,15.5
2015-11-21,12,31,43,57.0,14
2015-11-21,14,20,34,46.5,12.5
2015-11-21,23,22,45,56.5,11.5
2015-11-21,30,27,57,61.5,4.5
2015-11-21,31,21,52,55.5,3.5
2015-11-21,49,0,49,57.0,8
2015-11-21,35,38,73,53.5,-19.5
2015-11-21,20,40,60,54.5,-5.5
2015-11-21,47,28,75,65.0,-10
2015-11-21,23,32,55,48.0,-7
2015-11-21,28,16,44,43.0,-1
2015-11-21,21,38,59,57.0,-2
2015-11-21,29,42,71,54.0,-17
2015-11-21,20,13,33,55.5,22.5
2015-11-21,10,24,34,61.0,27
2015-11-21,63,7,70,65.5,-4.5
2015-11-21,13,52,65,51.0,-14
2015-11-21,10,52,62,57.5,-4.5
2015-11-21,27,31,58,54.5,-3.5
2015-11-21,31,56,87,61.0,-26
2015-11-21,17,15,32,54.0,22
2015-11-21,17,20,37,49.0,12
2015-11-21,21,42,63,44.5,-18.5
2015-11-21,17,38,55,55.0,0
2015-11-21,13,33,46,48.0,2
2015-11-21,34,42,76,53.0,-23
2015-11-21,37,52,89,68.5,-20.5
2015-11-21,28,48,76,72.0,-4
2015-11-21,17,9,26,55.5,29.5
2015-11-21,13,7,20,40.5,20.5
2015-11-21,17,14,31,52.5,21.5
2015-11-21,34,45,79,48.5,-30.5
2015-11-21,34,56,90,64.0,-26
2015-11-21,6,56,62,50.0,-12
2015-11-21,37,34,71,63.0,-8
2015-11-21,28,21,49,57.5,8.5
2015-11-21,52,7,59,48.5,-10.5
2015-11-21,51,50,101,58.5,-42.5
2015-11-21,17,23,40,50.5,10.5
2015-11-21,44,21,65,68.5,3.5
2015-11-21,24,34,58,57.0,-1
2015-11-21,19,8,27,42.5,15.5
2015-11-21,25,0,25,41.5,16.5
2015-11-21,16,19,35,43.0,8
2015-11-21,10,58,68,56.0,-12
2015-11-21,45,35,80,77.0,-3
2015-11-21,29,30,59,63.0,4
2015-11-21,21,49,70,56.0,-14
2015-11-21,52,14,66,53.5,-12.5
2015-11-21,22,35,57,64.0,7
2015-11-21,3,27,30,62.5,32.5
2015-11-21,42,23,65,53.5,-11.5
2015-11-24,48,10,58,74.0,16
2015-11-24,26,21,47,58.0,11
2015-11-26,44,3,47,54.0,7
2015-11-26,48,45,93,71.0,-22
2015-11-27,29,24,53,54.5,1.5
2015-11-27,28,49,77,64.0,-13
2015-11-27,31,52,83,59.5,-23.5
2015-11-27,35,30,65,59.0,-6
2015-11-27,0,20,20,39.0,19
2015-11-27,28,35,63,59.0,-4
2015-11-27,21,31,52,56.0,4
2015-11-27,3,28,31,44.0,13
2015-11-27,10,45,55,52.5,-2.5
2015-11-27,28,20,48,58.0,10
2015-11-27,40,23,63,57.5,-5.5
2015-11-27,42,52,94,70.5,-23.5
2015-11-27,31,26,57,55.0,-2
2015-11-27,21,28,49,74.5,25.5
2015-11-27,45,34,79,62.0,-17
2015-11-28,6,30,36,57.0,21
2015-11-28,19,16,35,69.5,34.5
2015-11-28,0,63,63,70.0,7
2015-11-28,54,36,90,69.5,-20.5
2015-11-28,46,41,87,55.5,-31.5
2015-11-28,58,24,82,62.0,-20
2015-11-28,42,13,55,46.5,-8.5
2015-11-28,33,31,64,54.0,-10
2015-11-28,37,32,69,58.0,-11
2015-11-28,23,20,43,47.0,4
2015-11-28,13,7,20,48.5,28.5
2015-11-28,38,24,62,52.0,-10
2015-11-28,17,20,37,39.0,2
2015-11-28,27,21,48,45.5,-2.5
2015-11-28,28,35,63,56.5,-6.5
2015-11-28,7,28,35,59.5,24.5
2015-11-28,17,55,72,56.0,-16
2015-11-28,42,7,49,58.5,9.5
2015-11-28,14,20,34,48.0,14
2015-11-28,24,14,38,42.0,4
2015-11-28,7,27,34,58.0,24
2015-11-28,16,55,71,43.5,-27.5
2015-11-28,31,21,52,44.0,-8
2015-11-28,20,17,37,51.0,14
2015-11-28,45,34,79,66.0,-13
2015-11-28,29,13,42,48.0,6
2015-11-28,21,40,61,61.0,0
2015-11-28,51,28,79,55.0,-24
2015-11-28,52,28,80,70.5,-9.5
2015-11-28,28,53,81,41.5,-39.5
2015-11-28,45,14,59,53.0,-6
2015-11-28,31,38,69,67.0,-2
2015-11-28,3,27,30,39.0,9
2015-11-28,38,27,65,65.0,0
2015-11-28,27,2,29,44.0,15
2015-11-28,7,19,26,55.5,29.5
2015-11-28,36,38,74,57.0,-17
2015-11-28,58,23,81,66.5,-14.5
2015-11-28,34,31,65,59.0,-6
2015-11-28,46,48,94,67.0,-27
2015-11-28,35,47,82,53.5,-28.5
2015-11-28,14,31,45,49.0,4
2015-11-28,26,28,54,54.0,0
2015-12-04,34,14,48,69.0,21
2015-12-05,13,24,37,52.5,15.5
2015-12-05,23,17,40,67.6,27.6
2015-12-05,28,45,73,74.0,1
2015-12-05,34,7,41,58.5,17.5
2015-12-05,17,55,72,70.0,-2
2015-12-05,35,42,77,59.0,-18
2015-12-05,15,29,44,39.5,-4.5
2015-12-05,23,24,47,56.5,9.5
2015-12-05,41,17,58,58.5,0.5
2015-12-05,34,27,61,58.5,-2.5
2015-12-05,24,27,51,49.5,-1.5
2015-12-05,22,41,63,59.0,-4
2015-12-05,16,13,29,51.0,22
2015-12-05,37,45,82,67.5,-14.5
2015-12-12,17,21,38,50.0,12
2015-12-19,45,37,82,65.0,-17
2015-12-19,28,35,63,51.0,-12
2015-12-19,29,31,60,55.0,-5
2015-12-19,27,16,43,55.5,12.5
2015-12-19,28,47,75,68.0,-7
2015-12-21,45,35,80,67.5,-12.5
2015-12-22,23,21,44,45.5,1.5
2015-12-22,17,32,49,48.5,-0.5
2015-12-23,55,7,62,56.0,-6
2015-12-23,58,27,85,63.5,-21.5
2015-12-24,31,45,76,66.0,-10
2015-12-24,42,7,49,56.5,7.5
2015-12-26,10,16,26,44.5,18.5
2015-12-26,14,20,34,62.0,28
2015-12-26,44,31,75,52.0,-23
2015-12-26,41,44,85,72.5,-12.5
2015-12-26,52,55,107,62.0,-45
2015-12-26,29,37,66,61.5,-4.5
2015-12-28,28,44,72,53.0,-19
2015-12-28,14,21,35,49.5,14.5
2015-12-29,55,36,91,71.5,-19.5
2015-12-29,38,49,87,74.0,-13
2015-12-29,28,23,51,56.0,5
2015-12-29,56,27,83,74.0,-9
2015-12-30,31,10,41,65.0,24
2015-12-30,28,51,79,61.0,-18
2015-12-30,21,27,48,49.0,1
2015-12-30,21,23,44,50.5,6.5
2015-12-31,38,24,62,56.5,-5.5
2015-12-31,17,37,54,63.5,9.5
2015-12-31,0,38,38,45.0,7
2016-01-01,6,45,51,48.5,-2.5
2016-01-01,41,7,48,39.0,-9
2016-01-01,28,44,72,57.5,-14.5
2016-01-01,45,16,61,53.5,-7.5
2016-01-01,20,48,68,69.0,1
2016-01-02,17,24,41,44.5,3.5
2016-01-02,23,45,68,56.0,-12
2016-01-02,41,47,88,74.0,-14
2016-01-02,43,42,85,62.5,-22.5
2016-01-11,45,40,85,50.5,-34.5